                                                                                                                                                                                                                                                                        B
                                                                           0 0 0 0 0 0 0 0 0                                                                                                                                                                            B
                                                                          0                                                                                                                                                                                             B
                                                                    0  0 BBBBBBBBBBBBBBBBBBBBB                                                                                                                          0 0 0 0 0 0                                     B
                                                                   0                                                                                                                                                   0 0 0 0 0 0 0    0                               B
                                                                                                                                                                  000000                                        0     BBBBBBBBBBBBBBB     0                             B
                                                                 BBBBB                                                                                           BBBBBBBB                                  0 0                             0  0   0   0                 B
                                            0  0         0 0                                                                                                  0                                        0  BBBBBB                            0   0   0   0               B
                                                                                                                                                             BBB                                       0                                   BBBBBBBBBBBBBB               B
                         0 0 0 0 0         BBBBBBB      BBBBB                                                                                           0                                            0                                                                  B
                                                                                             00                                0                       BBB                                       0  BBB                                                PP               B
                        BBBBBBBBBBB                                                                        0 0 0 0                0                                                          0 0                                                       PP  00000000000  B
                       BB          B                              0     0                                                            0           BBB                                        BBBBB                            0                         BB  0 0 0 0 0 0  B
                      BB            B                                                     PP    PP                                      0        BBB                                                                     000000                        BB  00000000000  B
   0  0   0  0       BB              B                         0     0     0              PP    PP                                               BBB                                                                         0                         BB               B
BBBBBBBBBBBBBBBBBBBBBBBBBBBBBBBBBBBBBBBBBBBBBBBBBBBBBBBBBBBBBBBBBBBBBBBBBBBBBBBBBBBBBBBBBBBB    BBBBBBBBBBBBBBBBBBBBBBBBBBBBBBBBBBBBBBBBBBBBBBBBBBBB  B  B  B  B  B  B  B  BBBBBBBBBB  B  B       B  B  B  B  BBBBBBBBBBBBBBBBBBBBBBBBBB     BBBBBBBBBBBBBBBBBBBBBBBBBBBB