                                                                                                                                                                                                                                                                                      B
                                                                                                                                                                                                                                                                                      B
                                                                                                                                                          0 0 0    0 0 0                                                                                               00             B
                                                                                                                                                       0                                                                                                                              B
                                                                     0      0                                                                     0 0     BBBBBBBBBBBBBB                                                                                          0   BBBB  0         B
                                                                         0                                                                     0  BBB                        000000                                                                        0                 0        B
                                                              0     BB  BBB                                                                   0                             BBBBBBBB                                                                0     BBB    BBB         0        B
                                                  0       0  BB  B                                                                           0                                       0                                                        0    BBB                       0        B
                                        B     0       0  BB                                                                                BBB                                        0                                                            BBB                       0        B
                         00            BB    BB  BB  BB                                                                                                                                0                                                     BBB                             0        B
                                      BBB                                                                          0 0 0                                                                0                                                    BBB                            BBB       B
                        BBBB        0BBBB                                       0   0                             0 0 0 0                                                                      B                     BBB                                                      B  0 0  B
          0                         BBBBB                                         0   0                           BBBBBBB       BBBBBBBBBB                                                    BB                                0     0 0                                     B 0 0 0 B
     0000000                       BBBBBB                                                  PP              PP                     0  0  BB                   PP    PP                        BBB                PP       0 0      0  0 PP                        B     B      B  0 0  B
          0                       BBBBBBB                                                  PP   0   0   0  PP    0   0   0        0  0  BB                   PP    PP                       BBBB                PP      0 0 0      0   PP                BBB                  B       B
BBBBBBBBBBBBBBBBBBBBBBBBBBBBBBBBBBBBBBBBB                                      BBBBBBBBBBBBBB   B   B   B  BBBBBBBBBBBBBBBBBBBBBBBBBBBBBBBBBBBBBBBBBBBBBBBBBBBB    BBBBBBBBBBBBBBBBBBBBBBBBBBBBB    B  B  B  B  BBBBBBBBBBBBBBB  BBBB  BBB               BBB                  BBBBBBBBB